NO ./textures/pat.xpm
WE ./textures/pat2.xpm
EA ./textures/pat3.xpm
SO ./textures/pat4.xpm
F   160,168,60
C 255,162,0


	
		 1111111111111111111111111   
		1000000000110000000000001  
		1110S0001110000000000001111
		1001000000000000000000001
111111111111000001110000000000001111
10000000001100000111011111C111011
11110111111111011100000010001111
11110111111 11011101010010001
10000001101110111000000100011
11O100000000000110000001000011
11O1000000100000110101001000101
1100000111010101111101111000111
11110111C1110101 101111010001
11111111111111111111111111111
